"Code","Borough","Year","Retail","Food_Hotels","Total"
"E09000001","City of London",2003,530,920,1450
"E09000001","City of London",2004,540,940,1480
"E09000001","City of London",2005,565,965,1530
"E09000001","City of London",2006,585,950,1535
"E09000001","City of London",2007,565,995,1560
"E09000001","City of London",2008,580,980,1560
"E09000001","City of London",2009,1885,1710,3595
"E09000001","City of London",2010,570,1060,1630
"E09000001","City of London",2011,585,985,1570
"E09000001","City of London",2012,625,1020,1645
"E09000001","City of London",2013,655,990,1645
"E09000001","City of London",2014,660,1045,1705
"E09000001","City of London",2015,330,370,700
"E09000001","City of London",2016,755,1145,1900
"E09000001","City of London",2017,835,1200,2035
"E09000001","City of London",2018,995,1280,2275
"E09000001","City of London",2019,1425,1280,2705
"E09000001","City of London",2020,1330,475,1805
"E09000001","City of London",2021,1010,1295,2305
"E09000001","City of London",2022,1060,1220,2280
"E09000001","City of London",2023,940,1120,2060
"E09000001","City of London",2024,895,1110,2005
"E09000001","City of London",2025,775,1048,1823
"E09000001","City of London",2026,848,1048,1896
"E09000001","City of London",2027,848,1048,1896
"E09000001","City of London",2028,848,1048,1896
"E09000001","City of London",2029,848,1048,1896
"E09000001","City of London",2030,848,1048,1896
"E09000001","City of London",2031,848,1048,1896
"E09000002","Barking and Dagenham",2003,515,235,750
"E09000002","Barking and Dagenham",2004,510,220,730
"E09000002","Barking and Dagenham",2005,525,235,760
"E09000002","Barking and Dagenham",2006,515,230,745
"E09000002","Barking and Dagenham",2007,515,215,730
"E09000002","Barking and Dagenham",2008,530,260,790
"E09000002","Barking and Dagenham",2009,525,250,775
"E09000002","Barking and Dagenham",2010,525,240,765
"E09000002","Barking and Dagenham",2011,525,230,755
"E09000002","Barking and Dagenham",2012,570,320,890
"E09000002","Barking and Dagenham",2013,545,330,875
"E09000002","Barking and Dagenham",2014,605,345,950
"E09000002","Barking and Dagenham",2015,470,280,750
"E09000002","Barking and Dagenham",2016,625,385,1010
"E09000002","Barking and Dagenham",2017,630,400,1030
"E09000002","Barking and Dagenham",2018,645,410,1055
"E09000002","Barking and Dagenham",2019,710,430,1140
"E09000002","Barking and Dagenham",2020,565,335,900
"E09000002","Barking and Dagenham",2021,815,495,1310
"E09000002","Barking and Dagenham",2022,915,460,1375
"E09000002","Barking and Dagenham",2023,895,470,1365
"E09000002","Barking and Dagenham",2024,935,485,1420
"E09000002","Barking and Dagenham",2025,561,280,841
"E09000002","Barking and Dagenham",2026,579,293,872
"E09000002","Barking and Dagenham",2027,591,301,892
"E09000002","Barking and Dagenham",2028,597,307,904
"E09000002","Barking and Dagenham",2029,601,311,912
"E09000002","Barking and Dagenham",2030,604,314,918
"E09000002","Barking and Dagenham",2031,605,315,920
"E09000003","Barnet",2003,1645,750,2395
"E09000003","Barnet",2004,1640,700,2340
"E09000003","Barnet",2005,1655,725,2380
"E09000003","Barnet",2006,1660,760,2420
"E09000003","Barnet",2007,1650,710,2360
"E09000003","Barnet",2008,1825,835,2660
"E09000003","Barnet",2009,1845,865,2710
"E09000003","Barnet",2010,1765,830,2595
"E09000003","Barnet",2011,1775,795,2570
"E09000003","Barnet",2012,1860,845,2705
"E09000003","Barnet",2013,1890,875,2765
"E09000003","Barnet",2014,1945,905,2850
"E09000003","Barnet",2015,1545,790,2335
"E09000003","Barnet",2016,1985,945,2930
"E09000003","Barnet",2017,2020,975,2995
"E09000003","Barnet",2018,2165,1000,3165
"E09000003","Barnet",2019,2400,1000,3400
"E09000003","Barnet",2020,2300,870,3170
"E09000003","Barnet",2021,3495,1085,4580
"E09000003","Barnet",2022,3520,1135,4655
"E09000003","Barnet",2023,2910,1120,4030
"E09000003","Barnet",2024,2580,1210,3790
"E09000003","Barnet",2025,1883,859,2742
"E09000003","Barnet",2026,1925,872,2797
"E09000003","Barnet",2027,1956,880,2836
"E09000003","Barnet",2028,1979,885,2864
"E09000003","Barnet",2029,1996,888,2884
"E09000003","Barnet",2030,2008,889,2897
"E09000003","Barnet",2031,2017,890,2907
"E09000004","Bexley",2003,780,375,1155
"E09000004","Bexley",2004,785,375,1160
"E09000004","Bexley",2005,765,390,1155
"E09000004","Bexley",2006,750,380,1130
"E09000004","Bexley",2007,765,380,1145
"E09000004","Bexley",2008,810,420,1230
"E09000004","Bexley",2009,780,470,1250
"E09000004","Bexley",2010,775,480,1255
"E09000004","Bexley",2011,745,460,1205
"E09000004","Bexley",2012,770,480,1250
"E09000004","Bexley",2013,770,485,1255
"E09000004","Bexley",2014,810,505,1315
"E09000004","Bexley",2015,550,405,955
"E09000004","Bexley",2016,795,565,1360
"E09000004","Bexley",2017,800,550,1350
"E09000004","Bexley",2018,805,570,1375
"E09000004","Bexley",2019,815,580,1395
"E09000004","Bexley",2020,570,440,1010
"E09000004","Bexley",2021,855,615,1470
"E09000004","Bexley",2022,880,650,1530
"E09000004","Bexley",2023,855,640,1495
"E09000004","Bexley",2024,840,650,1490
"E09000004","Bexley",2025,776,452,1228
"E09000004","Bexley",2026,776,469,1245
"E09000004","Bexley",2027,776,478,1254
"E09000004","Bexley",2028,776,483,1259
"E09000004","Bexley",2029,776,486,1262
"E09000004","Bexley",2030,776,487,1263
"E09000004","Bexley",2031,776,488,1264
"E09000005","Brent",2003,1170,575,1745
"E09000005","Brent",2004,1125,585,1710
"E09000005","Brent",2005,1180,580,1760
"E09000005","Brent",2006,1165,575,1740
"E09000005","Brent",2007,1175,570,1745
"E09000005","Brent",2008,1280,670,1950
"E09000005","Brent",2009,1285,700,1985
"E09000005","Brent",2010,1250,675,1925
"E09000005","Brent",2011,1250,655,1905
"E09000005","Brent",2012,1340,705,2045
"E09000005","Brent",2013,1360,665,2025
"E09000005","Brent",2014,1450,700,2150
"E09000005","Brent",2015,1290,670,1960
"E09000005","Brent",2016,1535,815,2350
"E09000005","Brent",2017,1565,825,2390
"E09000005","Brent",2018,1600,915,2515
"E09000005","Brent",2019,1895,935,2830
"E09000005","Brent",2020,1720,810,2530
"E09000005","Brent",2021,2135,1000,3135
"E09000005","Brent",2022,1990,1090,3080
"E09000005","Brent",2023,1870,1080,2950
"E09000005","Brent",2024,1855,1120,2975
"E09000005","Brent",2025,1319,697,2016
"E09000005","Brent",2026,1348,716,2064
"E09000005","Brent",2027,1370,729,2099
"E09000005","Brent",2028,1386,737,2123
"E09000005","Brent",2029,1399,743,2142
"E09000005","Brent",2030,1408,747,2155
"E09000005","Brent",2031,1415,750,2165
"E09000006","Bromley",2003,1310,555,1865
"E09000006","Bromley",2004,1295,625,1920
"E09000006","Bromley",2005,1330,635,1965
"E09000006","Bromley",2006,1305,650,1955
"E09000006","Bromley",2007,1280,650,1930
"E09000006","Bromley",2008,1395,740,2135
"E09000006","Bromley",2009,1380,740,2120
"E09000006","Bromley",2010,1345,725,2070
"E09000006","Bromley",2011,1320,675,1995
"E09000006","Bromley",2012,1350,715,2065
"E09000006","Bromley",2013,1335,735,2070
"E09000006","Bromley",2014,1320,740,2060
"E09000006","Bromley",2015,875,595,1470
"E09000006","Bromley",2016,1355,795,2150
"E09000006","Bromley",2017,1415,810,2225
"E09000006","Bromley",2018,1665,855,2520
"E09000006","Bromley",2019,1570,855,2425
"E09000006","Bromley",2020,850,680,1530
"E09000006","Bromley",2021,1405,895,2300
"E09000006","Bromley",2022,1445,925,2370
"E09000006","Bromley",2023,1365,935,2300
"E09000006","Bromley",2024,1370,940,2310
"E09000006","Bromley",2025,1331,745,2076
"E09000006","Bromley",2026,1331,747,2078
"E09000006","Bromley",2027,1331,748,2079
"E09000006","Bromley",2028,1331,748,2079
"E09000006","Bromley",2029,1331,748,2079
"E09000006","Bromley",2030,1331,748,2079
"E09000006","Bromley",2031,1331,748,2079
"E09000007","Camden",2003,1825,1400,3225
"E09000007","Camden",2004,1745,1375,3120
"E09000007","Camden",2005,1755,1415,3170
"E09000007","Camden",2006,1710,1410,3120
"E09000007","Camden",2007,1710,1400,3110
"E09000007","Camden",2008,1845,1595,3440
"E09000007","Camden",2009,580,1050,1630
"E09000007","Camden",2010,1835,1695,3530
"E09000007","Camden",2011,1865,1615,3480
"E09000007","Camden",2012,1965,1675,3640
"E09000007","Camden",2013,1990,1685,3675
"E09000007","Camden",2014,2030,1770,3800
"E09000007","Camden",2015,1525,1255,2780
"E09000007","Camden",2016,2155,1895,4050
"E09000007","Camden",2017,2275,2020,4295
"E09000007","Camden",2018,2450,2140,4590
"E09000007","Camden",2019,2885,2170,5055
"E09000007","Camden",2020,2425,1375,3800
"E09000007","Camden",2021,3425,2190,5615
"E09000007","Camden",2022,3310,2230,5540
"E09000007","Camden",2023,3085,2195,5280
"E09000007","Camden",2024,3045,2300,5345
"E09000007","Camden",2025,1871,1658,3529
"E09000007","Camden",2026,1891,1682,3573
"E09000007","Camden",2027,1906,1692,3598
"E09000007","Camden",2028,1917,1696,3613
"E09000007","Camden",2029,1926,1697,3623
"E09000007","Camden",2030,1932,1698,3630
"E09000007","Camden",2031,1937,1698,3635
"E09000008","Croydon",2003,1405,685,2090
"E09000008","Croydon",2004,1355,680,2035
"E09000008","Croydon",2005,1370,680,2050
"E09000008","Croydon",2006,1390,665,2055
"E09000008","Croydon",2007,1380,660,2040
"E09000008","Croydon",2008,1510,740,2250
"E09000008","Croydon",2009,1485,740,2225
"E09000008","Croydon",2010,1430,705,2135
"E09000008","Croydon",2011,1440,700,2140
"E09000008","Croydon",2012,1450,750,2200
"E09000008","Croydon",2013,1455,785,2240
"E09000008","Croydon",2014,1425,825,2250
"E09000008","Croydon",2015,1025,705,1730
"E09000008","Croydon",2016,1495,935,2430
"E09000008","Croydon",2017,1525,990,2515
"E09000008","Croydon",2018,1540,1020,2560
"E09000008","Croydon",2019,1615,1015,2630
"E09000008","Croydon",2020,1425,835,2260
"E09000008","Croydon",2021,1710,1030,2740
"E09000008","Croydon",2022,1790,1070,2860
"E09000008","Croydon",2023,1610,1100,2710
"E09000008","Croydon",2024,1600,1100,2700
"E09000008","Croydon",2025,1487,767,2254
"E09000008","Croydon",2026,1479,784,2263
"E09000008","Croydon",2027,1477,797,2274
"E09000008","Croydon",2028,1476,805,2281
"E09000008","Croydon",2029,1475,810,2285
"E09000008","Croydon",2030,1475,814,2289
"E09000008","Croydon",2031,1475,816,2291
"E09000009","Ealing",2003,1365,640,2005
"E09000009","Ealing",2004,1330,635,1965
"E09000009","Ealing",2005,1400,625,2025
"E09000009","Ealing",2006,1455,630,2085
"E09000009","Ealing",2007,1460,705,2165
"E09000009","Ealing",2008,1630,800,2430
"E09000009","Ealing",2009,1600,790,2390
"E09000009","Ealing",2010,1585,770,2355
"E09000009","Ealing",2011,1435,750,2185
"E09000009","Ealing",2012,1510,805,2315
"E09000009","Ealing",2013,1505,805,2310
"E09000009","Ealing",2014,1610,845,2455
"E09000009","Ealing",2015,1420,730,2150
"E09000009","Ealing",2016,1780,940,2720
"E09000009","Ealing",2017,1945,955,2900
"E09000009","Ealing",2018,1915,990,2905
"E09000009","Ealing",2019,1895,1010,2905
"E09000009","Ealing",2020,1650,800,2450
"E09000009","Ealing",2021,2105,1055,3160
"E09000009","Ealing",2022,2170,1080,3250
"E09000009","Ealing",2023,2125,1045,3170
"E09000009","Ealing",2024,2100,1095,3195
"E09000009","Ealing",2025,1646,815,2461
"E09000009","Ealing",2026,1655,824,2479
"E09000009","Ealing",2027,1662,829,2491
"E09000009","Ealing",2028,1666,832,2498
"E09000009","Ealing",2029,1668,833,2501
"E09000009","Ealing",2030,1670,834,2504
"E09000009","Ealing",2031,1671,835,2506
"E09000010","Enfield",2003,1135,465,1600
"E09000010","Enfield",2004,1110,470,1580
"E09000010","Enfield",2005,1135,485,1620
"E09000010","Enfield",2006,1070,480,1550
"E09000010","Enfield",2007,1065,455,1520
"E09000010","Enfield",2008,1190,555,1745
"E09000010","Enfield",2009,1190,575,1765
"E09000010","Enfield",2010,1165,575,1740
"E09000010","Enfield",2011,1170,565,1735
"E09000010","Enfield",2012,1235,595,1830
"E09000010","Enfield",2013,1240,575,1815
"E09000010","Enfield",2014,1340,620,1960
"E09000010","Enfield",2015,985,600,1585
"E09000010","Enfield",2016,1305,695,2000
"E09000010","Enfield",2017,1330,695,2025
"E09000010","Enfield",2018,1315,715,2030
"E09000010","Enfield",2019,1305,745,2050
"E09000010","Enfield",2020,1270,645,1915
"E09000010","Enfield",2021,1675,820,2495
"E09000010","Enfield",2022,1695,900,2595
"E09000010","Enfield",2023,1590,905,2495
"E09000010","Enfield",2024,1560,950,2510
"E09000010","Enfield",2025,1221,582,1803
"E09000010","Enfield",2026,1240,599,1839
"E09000010","Enfield",2027,1251,610,1861
"E09000010","Enfield",2028,1257,617,1874
"E09000010","Enfield",2029,1261,622,1883
"E09000010","Enfield",2030,1263,624,1887
"E09000010","Enfield",2031,1264,626,1890
"E09000011","Greenwich",2003,750,380,1130
"E09000011","Greenwich",2004,745,390,1135
"E09000011","Greenwich",2005,760,390,1150
"E09000011","Greenwich",2006,765,395,1160
"E09000011","Greenwich",2007,790,385,1175
"E09000011","Greenwich",2008,870,455,1325
"E09000011","Greenwich",2009,845,450,1295
"E09000011","Greenwich",2010,840,455,1295
"E09000011","Greenwich",2011,825,440,1265
"E09000011","Greenwich",2012,900,565,1465
"E09000011","Greenwich",2013,875,585,1460
"E09000011","Greenwich",2014,915,615,1530
"E09000011","Greenwich",2015,685,425,1110
"E09000011","Greenwich",2016,940,655,1595
"E09000011","Greenwich",2017,975,680,1655
"E09000011","Greenwich",2018,975,695,1670
"E09000011","Greenwich",2019,1015,715,1730
"E09000011","Greenwich",2020,765,480,1245
"E09000011","Greenwich",2021,1125,775,1900
"E09000011","Greenwich",2022,1180,810,1990
"E09000011","Greenwich",2023,1165,800,1965
"E09000011","Greenwich",2024,1250,835,2085
"E09000011","Greenwich",2025,890,499,1389
"E09000011","Greenwich",2026,898,523,1421
"E09000011","Greenwich",2027,902,536,1438
"E09000011","Greenwich",2028,903,543,1446
"E09000011","Greenwich",2029,904,547,1451
"E09000011","Greenwich",2030,904,549,1453
"E09000011","Greenwich",2031,904,550,1454
"E09000012","Hackney",2003,900,430,1330
"E09000012","Hackney",2004,905,480,1385
"E09000012","Hackney",2005,870,490,1360
"E09000012","Hackney",2006,890,490,1380
"E09000012","Hackney",2007,895,470,1365
"E09000012","Hackney",2008,985,570,1555
"E09000012","Hackney",2009,1020,615,1635
"E09000012","Hackney",2010,1000,595,1595
"E09000012","Hackney",2011,1025,605,1630
"E09000012","Hackney",2012,1085,690,1775
"E09000012","Hackney",2013,1135,715,1850
"E09000012","Hackney",2014,1235,805,2040
"E09000012","Hackney",2015,1135,840,1975
"E09000012","Hackney",2016,1365,980,2345
"E09000012","Hackney",2017,1450,1050,2500
"E09000012","Hackney",2018,1535,1100,2635
"E09000012","Hackney",2019,1635,1125,2760
"E09000012","Hackney",2020,1525,1000,2525
"E09000012","Hackney",2021,2015,1215,3230
"E09000012","Hackney",2022,2185,1310,3495
"E09000012","Hackney",2023,2220,1335,3555
"E09000012","Hackney",2024,2170,1370,3540
"E09000012","Hackney",2025,1052,625,1677
"E09000012","Hackney",2026,1102,666,1768
"E09000012","Hackney",2027,1140,697,1837
"E09000012","Hackney",2028,1169,719,1888
"E09000012","Hackney",2029,1191,735,1926
"E09000012","Hackney",2030,1207,748,1955
"E09000012","Hackney",2031,1219,757,1976
"E09000013","Hammersmith and Fulham",2003,1065,630,1695
"E09000013","Hammersmith and Fulham",2004,1045,640,1685
"E09000013","Hammersmith and Fulham",2005,1055,660,1715
"E09000013","Hammersmith and Fulham",2006,1040,660,1700
"E09000013","Hammersmith and Fulham",2007,1040,650,1690
"E09000013","Hammersmith and Fulham",2008,1110,745,1855
"E09000013","Hammersmith and Fulham",2009,1095,705,1800
"E09000013","Hammersmith and Fulham",2010,1200,700,1900
"E09000013","Hammersmith and Fulham",2011,1240,720,1960
"E09000013","Hammersmith and Fulham",2012,1310,755,2065
"E09000013","Hammersmith and Fulham",2013,1365,770,2135
"E09000013","Hammersmith and Fulham",2014,1395,795,2190
"E09000013","Hammersmith and Fulham",2015,910,600,1510
"E09000013","Hammersmith and Fulham",2016,1470,835,2305
"E09000013","Hammersmith and Fulham",2017,1445,875,2320
"E09000013","Hammersmith and Fulham",2018,1485,915,2400
"E09000013","Hammersmith and Fulham",2019,1480,925,2405
"E09000013","Hammersmith and Fulham",2020,895,635,1530
"E09000013","Hammersmith and Fulham",2021,1570,910,2480
"E09000013","Hammersmith and Fulham",2022,1540,945,2485
"E09000013","Hammersmith and Fulham",2023,1455,910,2365
"E09000013","Hammersmith and Fulham",2024,1470,955,2425
"E09000013","Hammersmith and Fulham",2025,1258,760,2018
"E09000013","Hammersmith and Fulham",2026,1258,765,2023
"E09000013","Hammersmith and Fulham",2027,1258,767,2025
"E09000013","Hammersmith and Fulham",2028,1258,767,2025
"E09000013","Hammersmith and Fulham",2029,1258,768,2026
"E09000013","Hammersmith and Fulham",2030,1258,768,2026
"E09000013","Hammersmith and Fulham",2031,1258,768,2026
"E09000014","Haringey",2003,1060,380,1440
"E09000014","Haringey",2004,1045,390,1435
"E09000014","Haringey",2005,1050,425,1475
"E09000014","Haringey",2006,1070,415,1485
"E09000014","Haringey",2007,1065,395,1460
"E09000014","Haringey",2008,1115,500,1615
"E09000014","Haringey",2009,1120,495,1615
"E09000014","Haringey",2010,1125,475,1600
"E09000014","Haringey",2011,1145,450,1595
"E09000014","Haringey",2012,1185,495,1680
"E09000014","Haringey",2013,1160,520,1680
"E09000014","Haringey",2014,1205,555,1760
"E09000014","Haringey",2015,965,580,1545
"E09000014","Haringey",2016,1250,680,1930
"E09000014","Haringey",2017,1245,710,1955
"E09000014","Haringey",2018,1275,730,2005
"E09000014","Haringey",2019,1310,760,2070
"E09000014","Haringey",2020,1040,660,1700
"E09000014","Haringey",2021,1385,850,2235
"E09000014","Haringey",2022,1435,920,2355
"E09000014","Haringey",2023,1425,925,2350
"E09000014","Haringey",2024,1425,935,2360
"E09000014","Haringey",2025,1155,524,1679
"E09000014","Haringey",2026,1171,541,1712
"E09000014","Haringey",2027,1178,554,1732
"E09000014","Haringey",2028,1180,562,1742
"E09000014","Haringey",2029,1182,568,1750
"E09000014","Haringey",2030,1182,573,1755
"E09000014","Haringey",2031,1182,576,1758
"E09000015","Harrow",2003,950,385,1335
"E09000015","Harrow",2004,940,385,1325
"E09000015","Harrow",2005,965,400,1365
"E09000015","Harrow",2006,970,390,1360
"E09000015","Harrow",2007,960,400,1360
"E09000015","Harrow",2008,1025,455,1480
"E09000015","Harrow",2009,1010,475,1485
"E09000015","Harrow",2010,1000,465,1465
"E09000015","Harrow",2011,1040,455,1495
"E09000015","Harrow",2012,1140,480,1620
"E09000015","Harrow",2013,1130,490,1620
"E09000015","Harrow",2014,1135,520,1655
"E09000015","Harrow",2015,940,460,1400
"E09000015","Harrow",2016,1150,570,1720
"E09000015","Harrow",2017,1205,565,1770
"E09000015","Harrow",2018,1220,595,1815
"E09000015","Harrow",2019,1270,620,1890
"E09000015","Harrow",2020,1040,510,1550
"E09000015","Harrow",2021,1385,640,2025
"E09000015","Harrow",2022,1450,680,2130
"E09000015","Harrow",2023,1405,680,2085
"E09000015","Harrow",2024,1450,705,2155
"E09000015","Harrow",2025,1066,475,1541
"E09000015","Harrow",2026,1088,488,1576
"E09000015","Harrow",2027,1100,495,1595
"E09000015","Harrow",2028,1107,500,1607
"E09000015","Harrow",2029,1111,503,1614
"E09000015","Harrow",2030,1113,505,1618
"E09000015","Harrow",2031,1114,506,1620
"E09000016","Havering",2003,980,325,1305
"E09000016","Havering",2004,965,340,1305
"E09000016","Havering",2005,990,365,1355
"E09000016","Havering",2006,985,370,1355
"E09000016","Havering",2007,975,385,1360
"E09000016","Havering",2008,1025,450,1475
"E09000016","Havering",2009,995,460,1455
"E09000016","Havering",2010,965,460,1425
"E09000016","Havering",2011,950,430,1380
"E09000016","Havering",2012,970,475,1445
"E09000016","Havering",2013,980,470,1450
"E09000016","Havering",2014,1020,490,1510
"E09000016","Havering",2015,685,440,1125
"E09000016","Havering",2016,1040,555,1595
"E09000016","Havering",2017,1045,595,1640
"E09000016","Havering",2018,1000,590,1590
"E09000016","Havering",2019,1010,625,1635
"E09000016","Havering",2020,670,520,1190
"E09000016","Havering",2021,1055,730,1785
"E09000016","Havering",2022,1105,680,1785
"E09000016","Havering",2023,1075,700,1775
"E09000016","Havering",2024,1050,685,1735
"E09000016","Havering",2025,979,468,1447
"E09000016","Havering",2026,979,480,1459
"E09000016","Havering",2027,979,487,1466
"E09000016","Havering",2028,979,491,1470
"E09000016","Havering",2029,979,494,1473
"E09000016","Havering",2030,979,496,1475
"E09000016","Havering",2031,979,497,1476
"E09000017","Hillingdon",2003,1160,640,1800
"E09000017","Hillingdon",2004,1140,635,1775
"E09000017","Hillingdon",2005,1160,655,1815
"E09000017","Hillingdon",2006,1150,635,1785
"E09000017","Hillingdon",2007,1195,635,1830
"E09000017","Hillingdon",2008,1245,720,1965
"E09000017","Hillingdon",2009,1230,745,1975
"E09000017","Hillingdon",2010,1205,725,1930
"E09000017","Hillingdon",2011,1225,680,1905
"E09000017","Hillingdon",2012,1285,730,2015
"E09000017","Hillingdon",2013,1295,730,2025
"E09000017","Hillingdon",2014,1300,775,2075
"E09000017","Hillingdon",2015,870,550,1420
"E09000017","Hillingdon",2016,1335,825,2160
"E09000017","Hillingdon",2017,1385,860,2245
"E09000017","Hillingdon",2018,1390,885,2275
"E09000017","Hillingdon",2019,1610,900,2510
"E09000017","Hillingdon",2020,1090,605,1695
"E09000017","Hillingdon",2021,1710,995,2705
"E09000017","Hillingdon",2022,1735,1015,2750
"E09000017","Hillingdon",2023,1740,990,2730
"E09000017","Hillingdon",2024,1735,1030,2765
"E09000017","Hillingdon",2025,1294,750,2044
"E09000017","Hillingdon",2026,1312,762,2074
"E09000017","Hillingdon",2027,1318,766,2084
"E09000017","Hillingdon",2028,1321,768,2089
"E09000017","Hillingdon",2029,1322,769,2091
"E09000017","Hillingdon",2030,1322,769,2091
"E09000017","Hillingdon",2031,1322,769,2091
"E09000018","Hounslow",2003,885,485,1370
"E09000018","Hounslow",2004,875,495,1370
"E09000018","Hounslow",2005,900,540,1440
"E09000018","Hounslow",2006,905,525,1430
"E09000018","Hounslow",2007,915,560,1475
"E09000018","Hounslow",2008,985,630,1615
"E09000018","Hounslow",2009,1020,655,1675
"E09000018","Hounslow",2010,1010,610,1620
"E09000018","Hounslow",2011,1010,585,1595
"E09000018","Hounslow",2012,1075,640,1715
"E09000018","Hounslow",2013,1080,640,1720
"E09000018","Hounslow",2014,1130,645,1775
"E09000018","Hounslow",2015,840,505,1345
"E09000018","Hounslow",2016,1165,685,1850
"E09000018","Hounslow",2017,1200,775,1975
"E09000018","Hounslow",2018,1210,840,2050
"E09000018","Hounslow",2019,1225,845,2070
"E09000018","Hounslow",2020,945,585,1530
"E09000018","Hounslow",2021,1360,845,2205
"E09000018","Hounslow",2022,1435,870,2305
"E09000018","Hounslow",2023,1440,895,2335
"E09000018","Hounslow",2024,1480,905,2385
"E09000018","Hounslow",2025,1038,649,1687
"E09000018","Hounslow",2026,1064,659,1723
"E09000018","Hounslow",2027,1076,664,1740
"E09000018","Hounslow",2028,1082,666,1748
"E09000018","Hounslow",2029,1085,667,1752
"E09000018","Hounslow",2030,1087,668,1755
"E09000018","Hounslow",2031,1087,668,1755
"E09000019","Islington",2003,1110,825,1935
"E09000019","Islington",2004,1050,800,1850
"E09000019","Islington",2005,1080,830,1910
"E09000019","Islington",2006,1030,820,1850
"E09000019","Islington",2007,1040,815,1855
"E09000019","Islington",2008,1120,960,2080
"E09000019","Islington",2009,1110,1090,2200
"E09000019","Islington",2010,1125,1045,2170
"E09000019","Islington",2011,1115,915,2030
"E09000019","Islington",2012,1170,1015,2185
"E09000019","Islington",2013,1190,1055,2245
"E09000019","Islington",2014,1335,1110,2445
"E09000019","Islington",2015,1075,885,1960
"E09000019","Islington",2016,1405,1220,2625
"E09000019","Islington",2017,1420,1240,2660
"E09000019","Islington",2018,1500,1300,2800
"E09000019","Islington",2019,1625,1350,2975
"E09000019","Islington",2020,1460,1030,2490
"E09000019","Islington",2021,1825,1385,3210
"E09000019","Islington",2022,1995,1455,3450
"E09000019","Islington",2023,1930,1465,3395
"E09000019","Islington",2024,2060,1480,3540
"E09000019","Islington",2025,1178,1013,2191
"E09000019","Islington",2026,1219,1044,2263
"E09000019","Islington",2027,1247,1062,2309
"E09000019","Islington",2028,1267,1072,2339
"E09000019","Islington",2029,1281,1078,2359
"E09000019","Islington",2030,1290,1082,2372
"E09000019","Islington",2031,1297,1084,2381
"E09000020","Kensington and Chelsea",2003,1665,965,2630
"E09000020","Kensington and Chelsea",2004,1670,970,2640
"E09000020","Kensington and Chelsea",2005,1665,970,2635
"E09000020","Kensington and Chelsea",2006,1700,950,2650
"E09000020","Kensington and Chelsea",2007,1700,955,2655
"E09000020","Kensington and Chelsea",2008,1705,990,2695
"E09000020","Kensington and Chelsea",2009,1700,1005,2705
"E09000020","Kensington and Chelsea",2010,1670,1015,2685
"E09000020","Kensington and Chelsea",2011,1760,970,2730
"E09000020","Kensington and Chelsea",2012,1785,1005,2790
"E09000020","Kensington and Chelsea",2013,1825,1000,2825
"E09000020","Kensington and Chelsea",2014,1875,1000,2875
"E09000020","Kensington and Chelsea",2015,1190,720,1910
"E09000020","Kensington and Chelsea",2016,1930,1065,2995
"E09000020","Kensington and Chelsea",2017,1955,1080,3035
"E09000020","Kensington and Chelsea",2018,1895,1100,2995
"E09000020","Kensington and Chelsea",2019,1880,1110,2990
"E09000020","Kensington and Chelsea",2020,1180,780,1960
"E09000020","Kensington and Chelsea",2021,1915,1125,3040
"E09000020","Kensington and Chelsea",2022,1930,1120,3050
"E09000020","Kensington and Chelsea",2023,1845,1115,2960
"E09000020","Kensington and Chelsea",2024,1850,1110,2960
"E09000020","Kensington and Chelsea",2025,1740,1005,2745
"E09000020","Kensington and Chelsea",2026,1740,1005,2745
"E09000020","Kensington and Chelsea",2027,1740,1005,2745
"E09000020","Kensington and Chelsea",2028,1740,1005,2745
"E09000020","Kensington and Chelsea",2029,1740,1005,2745
"E09000020","Kensington and Chelsea",2030,1740,1005,2745
"E09000020","Kensington and Chelsea",2031,1740,1005,2745
"E09000021","Kingston upon Thames",2003,825,390,1215
"E09000021","Kingston upon Thames",2004,790,390,1180
"E09000021","Kingston upon Thames",2005,800,405,1205
"E09000021","Kingston upon Thames",2006,790,410,1200
"E09000021","Kingston upon Thames",2007,785,415,1200
"E09000021","Kingston upon Thames",2008,850,460,1310
"E09000021","Kingston upon Thames",2009,840,470,1310
"E09000021","Kingston upon Thames",2010,825,445,1270
"E09000021","Kingston upon Thames",2011,835,430,1265
"E09000021","Kingston upon Thames",2012,850,455,1305
"E09000021","Kingston upon Thames",2013,850,460,1310
"E09000021","Kingston upon Thames",2014,860,480,1340
"E09000021","Kingston upon Thames",2015,515,370,885
"E09000021","Kingston upon Thames",2016,865,525,1390
"E09000021","Kingston upon Thames",2017,880,515,1395
"E09000021","Kingston upon Thames",2018,1010,525,1535
"E09000021","Kingston upon Thames",2019,1165,530,1695
"E09000021","Kingston upon Thames",2020,820,380,1200
"E09000021","Kingston upon Thames",2021,1425,555,1980
"E09000021","Kingston upon Thames",2022,1185,585,1770
"E09000021","Kingston upon Thames",2023,1315,580,1895
"E09000021","Kingston upon Thames",2024,1220,620,1840
"E09000021","Kingston upon Thames",2025,888,472,1360
"E09000021","Kingston upon Thames",2026,905,472,1377
"E09000021","Kingston upon Thames",2027,912,472,1384
"E09000021","Kingston upon Thames",2028,915,472,1387
"E09000021","Kingston upon Thames",2029,917,472,1389
"E09000021","Kingston upon Thames",2030,917,472,1389
"E09000021","Kingston upon Thames",2031,917,472,1389
"E09000022","Lambeth",2003,975,760,1735
"E09000022","Lambeth",2004,955,735,1690
"E09000022","Lambeth",2005,930,730,1660
"E09000022","Lambeth",2006,920,715,1635
"E09000022","Lambeth",2007,910,780,1690
"E09000022","Lambeth",2008,1025,870,1895
"E09000022","Lambeth",2009,1015,865,1880
"E09000022","Lambeth",2010,1010,865,1875
"E09000022","Lambeth",2011,1010,845,1855
"E09000022","Lambeth",2012,1050,900,1950
"E09000022","Lambeth",2013,1045,930,1975
"E09000022","Lambeth",2014,1100,1005,2105
"E09000022","Lambeth",2015,880,760,1640
"E09000022","Lambeth",2016,1150,1080,2230
"E09000022","Lambeth",2017,1165,1120,2285
"E09000022","Lambeth",2018,1165,1155,2320
"E09000022","Lambeth",2019,1210,1190,2400
"E09000022","Lambeth",2020,925,920,1845
"E09000022","Lambeth",2021,1320,1265,2585
"E09000022","Lambeth",2022,1405,1300,2705
"E09000022","Lambeth",2023,1345,1295,2640
"E09000022","Lambeth",2024,1315,1235,2550
"E09000022","Lambeth",2025,1052,903,1955
"E09000022","Lambeth",2026,1066,923,1989
"E09000022","Lambeth",2027,1072,936,2008
"E09000022","Lambeth",2028,1075,944,2019
"E09000022","Lambeth",2029,1077,948,2025
"E09000022","Lambeth",2030,1077,951,2028
"E09000022","Lambeth",2031,1078,953,2031
"E09000023","Lewisham",2003,875,460,1335
"E09000023","Lewisham",2004,860,450,1310
"E09000023","Lewisham",2005,850,460,1310
"E09000023","Lewisham",2006,855,460,1315
"E09000023","Lewisham",2007,850,455,1305
"E09000023","Lewisham",2008,935,540,1475
"E09000023","Lewisham",2009,915,570,1485
"E09000023","Lewisham",2010,890,545,1435
"E09000023","Lewisham",2011,900,450,1350
"E09000023","Lewisham",2012,925,540,1465
"E09000023","Lewisham",2013,925,530,1455
"E09000023","Lewisham",2014,960,570,1530
"E09000023","Lewisham",2015,730,525,1255
"E09000023","Lewisham",2016,980,700,1680
"E09000023","Lewisham",2017,990,720,1710
"E09000023","Lewisham",2018,985,755,1740
"E09000023","Lewisham",2019,995,790,1785
"E09000023","Lewisham",2020,730,655,1385
"E09000023","Lewisham",2021,1045,875,1920
"E09000023","Lewisham",2022,1100,895,1995
"E09000023","Lewisham",2023,1090,870,1960
"E09000023","Lewisham",2024,1070,900,1970
"E09000023","Lewisham",2025,930,563,1493
"E09000023","Lewisham",2026,930,579,1509
"E09000023","Lewisham",2027,930,590,1520
"E09000023","Lewisham",2028,930,597,1527
"E09000023","Lewisham",2029,930,602,1532
"E09000023","Lewisham",2030,930,605,1535
"E09000023","Lewisham",2031,930,608,1538
"E09000024","Merton",2003,745,335,1080
"E09000024","Merton",2004,730,330,1060
"E09000024","Merton",2005,770,340,1110
"E09000024","Merton",2006,760,345,1105
"E09000024","Merton",2007,780,350,1130
"E09000024","Merton",2008,850,390,1240
"E09000024","Merton",2009,835,425,1260
"E09000024","Merton",2010,825,420,1245
"E09000024","Merton",2011,860,395,1255
"E09000024","Merton",2012,870,405,1275
"E09000024","Merton",2013,845,425,1270
"E09000024","Merton",2014,880,435,1315
"E09000024","Merton",2015,645,390,1035
"E09000024","Merton",2016,940,510,1450
"E09000024","Merton",2017,935,510,1445
"E09000024","Merton",2018,965,565,1530
"E09000024","Merton",2019,970,585,1555
"E09000024","Merton",2020,690,410,1100
"E09000024","Merton",2021,1015,615,1630
"E09000024","Merton",2022,1055,630,1685
"E09000024","Merton",2023,1035,590,1625
"E09000024","Merton",2024,1035,660,1695
"E09000024","Merton",2025,865,419,1284
"E09000024","Merton",2026,865,434,1299
"E09000024","Merton",2027,865,443,1308
"E09000024","Merton",2028,865,447,1312
"E09000024","Merton",2029,865,450,1315
"E09000024","Merton",2030,865,451,1316
"E09000024","Merton",2031,865,452,1317
"E09000025","Newham",2003,1025,335,1360
"E09000025","Newham",2004,1005,345,1350
"E09000025","Newham",2005,1025,350,1375
"E09000025","Newham",2006,1035,380,1415
"E09000025","Newham",2007,1030,355,1385
"E09000025","Newham",2008,1110,400,1510
"E09000025","Newham",2009,1120,420,1540
"E09000025","Newham",2010,1090,395,1485
"E09000025","Newham",2011,1120,380,1500
"E09000025","Newham",2012,1235,440,1675
"E09000025","Newham",2013,1345,520,1865
"E09000025","Newham",2014,1465,545,2010
"E09000025","Newham",2015,1075,490,1565
"E09000025","Newham",2016,1550,675,2225
"E09000025","Newham",2017,1590,685,2275
"E09000025","Newham",2018,1615,720,2335
"E09000025","Newham",2019,1760,850,2610
"E09000025","Newham",2020,1385,600,1985
"E09000025","Newham",2021,2025,950,2975
"E09000025","Newham",2022,2365,1045,3410
"E09000025","Newham",2023,2170,1025,3195
"E09000025","Newham",2024,2045,1095,3140
"E09000025","Newham",2025,1191,454,1645
"E09000025","Newham",2026,1246,491,1737
"E09000025","Newham",2027,1284,515,1799
"E09000025","Newham",2028,1311,531,1842
"E09000025","Newham",2029,1328,542,1870
"E09000025","Newham",2030,1341,549,1890
"E09000025","Newham",2031,1349,554,1903
"E09000026","Redbridge",2003,1025,365,1390
"E09000026","Redbridge",2004,1025,375,1400
"E09000026","Redbridge",2005,1025,390,1415
"E09000026","Redbridge",2006,1010,390,1400
"E09000026","Redbridge",2007,1010,385,1395
"E09000026","Redbridge",2008,1070,450,1520
"E09000026","Redbridge",2009,1065,500,1565
"E09000026","Redbridge",2010,1045,480,1525
"E09000026","Redbridge",2011,1075,465,1540
"E09000026","Redbridge",2012,1115,505,1620
"E09000026","Redbridge",2013,1135,525,1660
"E09000026","Redbridge",2014,1205,550,1755
"E09000026","Redbridge",2015,975,505,1480
"E09000026","Redbridge",2016,1220,600,1820
"E09000026","Redbridge",2017,1285,635,1920
"E09000026","Redbridge",2018,1310,650,1960
"E09000026","Redbridge",2019,1355,645,2000
"E09000026","Redbridge",2020,1280,555,1835
"E09000026","Redbridge",2021,1715,690,2405
"E09000026","Redbridge",2022,1635,790,2425
"E09000026","Redbridge",2023,1600,825,2425
"E09000026","Redbridge",2024,1565,890,2455
"E09000026","Redbridge",2025,1107,486,1593
"E09000026","Redbridge",2026,1133,507,1640
"E09000026","Redbridge",2027,1151,521,1672
"E09000026","Redbridge",2028,1163,529,1692
"E09000026","Redbridge",2029,1171,535,1706
"E09000026","Redbridge",2030,1177,538,1715
"E09000026","Redbridge",2031,1181,540,1721
"E09000027","Richmond upon Thames",2003,975,540,1515
"E09000027","Richmond upon Thames",2004,955,555,1510
"E09000027","Richmond upon Thames",2005,960,570,1530
"E09000027","Richmond upon Thames",2006,965,570,1535
"E09000027","Richmond upon Thames",2007,965,560,1525
"E09000027","Richmond upon Thames",2008,1030,605,1635
"E09000027","Richmond upon Thames",2009,1040,655,1695
"E09000027","Richmond upon Thames",2010,1035,650,1685
"E09000027","Richmond upon Thames",2011,1035,570,1605
"E09000027","Richmond upon Thames",2012,1040,610,1650
"E09000027","Richmond upon Thames",2013,1035,605,1640
"E09000027","Richmond upon Thames",2014,1065,630,1695
"E09000027","Richmond upon Thames",2015,775,490,1265
"E09000027","Richmond upon Thames",2016,1070,675,1745
"E09000027","Richmond upon Thames",2017,1065,700,1765
"E09000027","Richmond upon Thames",2018,1070,690,1760
"E09000027","Richmond upon Thames",2019,1095,710,1805
"E09000027","Richmond upon Thames",2020,795,520,1315
"E09000027","Richmond upon Thames",2021,1140,730,1870
"E09000027","Richmond upon Thames",2022,1165,755,1920
"E09000027","Richmond upon Thames",2023,1130,735,1865
"E09000027","Richmond upon Thames",2024,1105,765,1870
"E09000027","Richmond upon Thames",2025,1023,631,1654
"E09000027","Richmond upon Thames",2026,1023,631,1654
"E09000027","Richmond upon Thames",2027,1023,631,1654
"E09000027","Richmond upon Thames",2028,1023,631,1654
"E09000027","Richmond upon Thames",2029,1023,631,1654
"E09000027","Richmond upon Thames",2030,1023,631,1654
"E09000027","Richmond upon Thames",2031,1023,631,1654
"E09000028","Southwark",2003,1000,800,1800
"E09000028","Southwark",2004,975,805,1780
"E09000028","Southwark",2005,985,840,1825
"E09000028","Southwark",2006,990,835,1825
"E09000028","Southwark",2007,1020,870,1890
"E09000028","Southwark",2008,1140,985,2125
"E09000028","Southwark",2009,1150,980,2130
"E09000028","Southwark",2010,1095,965,2060
"E09000028","Southwark",2011,1125,855,1980
"E09000028","Southwark",2012,1170,900,2070
"E09000028","Southwark",2013,1185,930,2115
"E09000028","Southwark",2014,1225,995,2220
"E09000028","Southwark",2015,985,790,1775
"E09000028","Southwark",2016,1270,1125,2395
"E09000028","Southwark",2017,1520,1190,2710
"E09000028","Southwark",2018,1400,1265,2665
"E09000028","Southwark",2019,1495,1315,2810
"E09000028","Southwark",2020,1370,965,2335
"E09000028","Southwark",2021,2010,1375,3385
"E09000028","Southwark",2022,2175,1420,3595
"E09000028","Southwark",2023,1710,1420,3130
"E09000028","Southwark",2024,1635,1480,3115
"E09000028","Southwark",2025,1181,1011,2192
"E09000028","Southwark",2026,1209,1026,2235
"E09000028","Southwark",2027,1229,1034,2263
"E09000028","Southwark",2028,1243,1038,2281
"E09000028","Southwark",2029,1252,1041,2293
"E09000028","Southwark",2030,1259,1042,2301
"E09000028","Southwark",2031,1264,1043,2307
"E09000029","Sutton",2003,785,320,1105
"E09000029","Sutton",2004,775,315,1090
"E09000029","Sutton",2005,770,325,1095
"E09000029","Sutton",2006,735,325,1060
"E09000029","Sutton",2007,710,330,1040
"E09000029","Sutton",2008,770,405,1175
"E09000029","Sutton",2009,755,400,1155
"E09000029","Sutton",2010,725,375,1100
"E09000029","Sutton",2011,705,355,1060
"E09000029","Sutton",2012,720,375,1095
"E09000029","Sutton",2013,720,390,1110
"E09000029","Sutton",2014,725,405,1130
"E09000029","Sutton",2015,510,350,860
"E09000029","Sutton",2016,720,460,1180
"E09000029","Sutton",2017,740,485,1225
"E09000029","Sutton",2018,740,485,1225
"E09000029","Sutton",2019,790,485,1275
"E09000029","Sutton",2020,545,400,945
"E09000029","Sutton",2021,795,515,1310
"E09000029","Sutton",2022,795,530,1325
"E09000029","Sutton",2023,790,530,1320
"E09000029","Sutton",2024,790,540,1330
"E09000029","Sutton",2025,732,408,1140
"E09000029","Sutton",2026,732,410,1142
"E09000029","Sutton",2027,732,411,1143
"E09000029","Sutton",2028,732,411,1143
"E09000029","Sutton",2029,732,412,1144
"E09000029","Sutton",2030,732,412,1144
"E09000029","Sutton",2031,732,412,1144
"E09000030","Tower Hamlets",2003,865,720,1585
"E09000030","Tower Hamlets",2004,850,650,1500
"E09000030","Tower Hamlets",2005,870,680,1550
"E09000030","Tower Hamlets",2006,895,675,1570
"E09000030","Tower Hamlets",2007,915,695,1610
"E09000030","Tower Hamlets",2008,1040,785,1825
"E09000030","Tower Hamlets",2009,1100,830,1930
"E09000030","Tower Hamlets",2010,1100,825,1925
"E09000030","Tower Hamlets",2011,1105,790,1895
"E09000030","Tower Hamlets",2012,1200,910,2110
"E09000030","Tower Hamlets",2013,1225,940,2165
"E09000030","Tower Hamlets",2014,1260,1040,2300
"E09000030","Tower Hamlets",2015,1080,820,1900
"E09000030","Tower Hamlets",2016,1400,1175,2575
"E09000030","Tower Hamlets",2017,1485,1205,2690
"E09000030","Tower Hamlets",2018,1595,1240,2835
"E09000030","Tower Hamlets",2019,1525,1295,2820
"E09000030","Tower Hamlets",2020,1265,975,2240
"E09000030","Tower Hamlets",2021,1680,1430,3110
"E09000030","Tower Hamlets",2022,1740,1530,3270
"E09000030","Tower Hamlets",2023,1730,1480,3210
"E09000030","Tower Hamlets",2024,1770,1495,3265
"E09000030","Tower Hamlets",2025,1103,848,1951
"E09000030","Tower Hamlets",2026,1144,890,2034
"E09000030","Tower Hamlets",2027,1172,919,2091
"E09000030","Tower Hamlets",2028,1191,938,2129
"E09000030","Tower Hamlets",2029,1204,951,2155
"E09000030","Tower Hamlets",2030,1212,959,2171
"E09000030","Tower Hamlets",2031,1218,965,2183
"E09000031","Waltham Forest",2003,970,315,1285
"E09000031","Waltham Forest",2004,970,320,1290
"E09000031","Waltham Forest",2005,930,335,1265
"E09000031","Waltham Forest",2006,930,355,1285
"E09000031","Waltham Forest",2007,920,350,1270
"E09000031","Waltham Forest",2008,1005,410,1415
"E09000031","Waltham Forest",2009,970,405,1375
"E09000031","Waltham Forest",2010,960,395,1355
"E09000031","Waltham Forest",2011,975,380,1355
"E09000031","Waltham Forest",2012,1055,420,1475
"E09000031","Waltham Forest",2013,1065,440,1505
"E09000031","Waltham Forest",2014,1055,470,1525
"E09000031","Waltham Forest",2015,875,505,1380
"E09000031","Waltham Forest",2016,1125,610,1735
"E09000031","Waltham Forest",2017,1165,610,1775
"E09000031","Waltham Forest",2018,1150,630,1780
"E09000031","Waltham Forest",2019,1435,650,2085
"E09000031","Waltham Forest",2020,1265,600,1865
"E09000031","Waltham Forest",2021,1575,745,2320
"E09000031","Waltham Forest",2022,1475,800,2275
"E09000031","Waltham Forest",2023,1430,800,2230
"E09000031","Waltham Forest",2024,1390,835,2225
"E09000031","Waltham Forest",2025,1032,434,1466
"E09000031","Waltham Forest",2026,1051,452,1503
"E09000031","Waltham Forest",2027,1065,465,1530
"E09000031","Waltham Forest",2028,1075,474,1549
"E09000031","Waltham Forest",2029,1082,480,1562
"E09000031","Waltham Forest",2030,1086,485,1571
"E09000031","Waltham Forest",2031,1090,488,1578
"E09000032","Wandsworth",2003,1355,710,2065
"E09000032","Wandsworth",2004,1295,720,2015
"E09000032","Wandsworth",2005,1315,735,2050
"E09000032","Wandsworth",2006,1360,755,2115
"E09000032","Wandsworth",2007,1345,785,2130
"E09000032","Wandsworth",2008,1425,910,2335
"E09000032","Wandsworth",2009,1385,930,2315
"E09000032","Wandsworth",2010,1355,880,2235
"E09000032","Wandsworth",2011,1355,860,2215
"E09000032","Wandsworth",2012,1375,880,2255
"E09000032","Wandsworth",2013,1435,890,2325
"E09000032","Wandsworth",2014,1475,950,2425
"E09000032","Wandsworth",2015,1075,725,1800
"E09000032","Wandsworth",2016,1545,1000,2545
"E09000032","Wandsworth",2017,1495,1000,2495
"E09000032","Wandsworth",2018,1495,1020,2515
"E09000032","Wandsworth",2019,1495,1090,2585
"E09000032","Wandsworth",2020,1055,765,1820
"E09000032","Wandsworth",2021,1535,1175,2710
"E09000032","Wandsworth",2022,1555,1190,2745
"E09000032","Wandsworth",2023,1505,1160,2665
"E09000032","Wandsworth",2024,1555,1165,2720
"E09000032","Wandsworth",2025,1399,917,2316
"E09000032","Wandsworth",2026,1399,920,2319
"E09000032","Wandsworth",2027,1399,922,2321
"E09000032","Wandsworth",2028,1399,922,2321
"E09000032","Wandsworth",2029,1399,922,2321
"E09000032","Wandsworth",2030,1399,922,2321
"E09000032","Wandsworth",2031,1399,922,2321
"E09000033","Westminster",2003,3935,3085,7020
"E09000033","Westminster",2004,3795,3200,6995
"E09000033","Westminster",2005,3810,3260,7070
"E09000033","Westminster",2006,3750,3225,6975
"E09000033","Westminster",2007,3700,3210,6910
"E09000033","Westminster",2008,4055,3440,7495
"E09000033","Westminster",2009,4030,3505,7535
"E09000033","Westminster",2010,3990,3445,7435
"E09000033","Westminster",2011,3935,3430,7365
"E09000033","Westminster",2012,4005,3575,7580
"E09000033","Westminster",2013,4065,3580,7645
"E09000033","Westminster",2014,4130,3640,7770
"E09000033","Westminster",2015,2760,2355,5115
"E09000033","Westminster",2016,4315,3705,8020
"E09000033","Westminster",2017,4260,3775,8035
"E09000033","Westminster",2018,4455,3890,8345
"E09000033","Westminster",2019,4980,3940,8920
"E09000033","Westminster",2020,3285,2535,5820
"E09000033","Westminster",2021,5200,3970,9170
"E09000033","Westminster",2022,5605,4000,9605
"E09000033","Westminster",2023,5000,4035,9035
"E09000033","Westminster",2024,4740,4045,8785
"E09000033","Westminster",2025,4173,3493,7666
"E09000033","Westminster",2026,4173,3493,7666
"E09000033","Westminster",2027,4173,3493,7666
"E09000033","Westminster",2028,4173,3493,7666
"E09000033","Westminster",2029,4173,3493,7666
"E09000033","Westminster",2030,4173,3493,7666
"E09000033","Westminster",2031,4173,3493,7666
"E12000007","London",2003,37545,21195,58740
"E12000007","London",2004,36800,21320,58120
"E12000007","London",2005,37215,21880,59095
"E12000007","London",2006,37105,21815,58920
"E12000007","London",2007,37080,21930,59010
"E12000007","London",2008,40085,24720,64805
"E12000007","London",2009,39920,25540,65460
"E12000007","London",2010,39330,24985,64315
"E12000007","London",2011,39480,23885,63365
"E12000007","London",2012,41190,25675,66865
"E12000007","London",2013,41655,26070,67725
"E12000007","London",2014,43145,27325,70470
"E12000007","London",2015,32190,21480,53670
"E12000007","London",2016,44985,30025,75010
"E12000007","London",2017,46240,31000,77240
"E12000007","London",2018,47535,32235,79770
"E12000007","London",2019,50845,33070,83915
"E12000007","London",2020,40125,24350,64475
"E12000007","London",2021,56455,34840,91295
"E12000007","London",2022,58020,36035,94055
"E12000007","London",2023,54795,35770,90565
"E12000007","London",2024,53955,36695,90650
"E12000007","London",2025,41494,25885,67379
"E12000007","London",2026,42248,26493,68741
"E12000007","London",2027,42652,26810,69462
"E12000007","London",2028,42867,26975,69842
"E12000007","London",2029,42983,27061,70044
"E12000007","London",2030,43044,27106,70150
"E12000007","London",2031,43077,27130,70207
